#############################################################
#A  # #   # #   #   # #     #   # #       #             #   #
# # # ### # ### # ### ##### # # # ### # # # # # ### # # # ###
# # #     # #     #       # # #   #   # # # # #   # # #   # #
# # # ### # ##### # ####### # # ##### ####### ### # # # # # #
# #   #       #     #   # #   # #             #   # # # # # #
# ##### # # # ##### # ### ##### ### ####### ####### ### # # #
#   #   # # #     #         #   # #       # # #   #   # #   #
####### ##### ### # # ### ### ### # ### # # # # ### ##### ###
#       # #   # # # #   # #     # # #   # # # #     # #     #
# ### # # # ### # ####### ### ### # # ####### ### # # # # ###
#   # # #       # #                 # #   #       #   # # # #
# ####### ##### ##### # ### # ### ### ### # # ####### ### # #
#   #   # #   #       #   # #   # #   # #   # # #   # #     #
# ##### # ### ### ### # ##### ### # ### ##### # ### ##### # #
# #   #   #   #   # # # # # #   # # #   # # #         # # # #
# ### # # # # ### # # ### # # ### ### ### # # # ### ### #####
#   #   # # #   #   # #     #   # # #     #   # #   # #     #
# ### # # ### ##### ####### ### ### # # # ### ### # # ##### #
#   # # #   #     # # # #   # # # #   # # #   #   #   # #   #
##### ### ### ### # # # ### # # # # ##### ### ######### # ###
#   #   # #   # # # #     # # #       #   # # #   #     #   #
# ######### ### ### ### ### # # ### ##### # ### # # ####### #
#       #   # # # #       #   #   # # #       # # #   #   # #
# # # ##### # # # # ######### ### ### # # # ### ### ### ### #
# # # #     # #     #   # #   #   #   # # #           #   # #
# ##### ##### ######### # ### ### # # ### ### ######### ### #
# #   # #   #         # # # # # #   #   # #             #   #
# # # # # ####### ### # # # # # ### ##### ### ####### ### ###
#   # #     # #   #   # # #     #     # # #   #   # #   #   #
# # ### # # # ### # ### # # # ##### ### # ### # ### # # ### #
# #     # # #   # # # #     #       # #   # #   #     #     #
# ##### ### ### # # # # # ### # ### # ### # ############# # #
#   # # # #   #   #     #   # #   # # #   #       #   #   # #
# ### ### ### # ####### ### # ### ### ### # # ####### ##### #
#     #   #     #       #   # #     #     # # #         #   #
##### # # ### ### ################# ### ### # # ######### # #
#       # # # # # #     #   #         # #   #   # # # #   # #
### ####### # # # ### ### ####### ### ####### ### # # # ### #
#   # # # #     #   #   #     # #   # #         #       # # #
# # # # # ##### ####### # ### # # ##### # ######### ### # # #
# #       #   # #   #   # #   # # #     # #           #   # #
##### # # # # ### # # ##### ### ##### ########### # # # #####
# #   # # # #     #     #       # #       #       # # # #   #
# ### ######### ### ######### # # ##### ######### ##### # # #
#           # # #     #   # # # # #   #               #   # #
### ### ##### # # ### # ### ### # # ##### # ### # ##### #####
#   # # #   # # # #   #           #       #   # #   # # # # #
# # # # # ### ####### # # ##### # ### ### ######### # ### # #
# #   #     #       # # #     # # #     # # #   #           #
##### # # ### ##### # # # # # ##### ### ### # ######### #####
# #   # #   # #       # # # # #     # #             # # # # #
# ### # ########### # # # ### ####### ##### ### ### # ### # #
# # # #   #   #   # # # # # # #           #   # # # #     # #
# # # ### # # # ##### ### # # # ####### # # ### # # ##### # #
#       # # #       #   # # # #   #     #   # #   # # # #   #
# ### ##### # # # ### ##### # # ### ### ### # ### # # # ### #
# # #     # # # # #     # #     # # # # #       # # #       #
### # # # ### ### # ##### # # # # # # # ### ####### ##### ###
#     # #   #   #           # # #   #   #       #          B#
#############################################################
