#############
########B####
######## ####
#######  ####
#A      #####
#############
